La vie en rose - Louis Armstrong | IIIIvideowatcherIIII
Around the World | Daft Punk
All or Nothing at All | Frank Sinatra
Beach Boys - Wouldn't It Be Nice | pieandjoe1
Your Love (Official HD Video) | The Outfield
Omae Wa Mou | deadman æ­»äºº
Sorry, I Like You | Burbank
in your arms | Saib
Don't Worry Baby (Mono) | The Beach Boys
engelwood - crystal dolphin | yotsu
Baby I'm Yours (feat. Irfane) | Breakbot
Mad at Disney | salem ilese
Beautiful Day Video | U2
Spandau Ballet - True (HD Remastered) | Spandau Ballet
Manuel - Gas Gas Gas | musoforlyf
Coffee | Beabadoobee
Dance With Me | Beabadoobee
Break My Face | AJR
Do It All The Time | I DONT KNOW HOW BUT THEY FOUND ME
Spain | Chick Corea
Overthinker | INZO
Harry James "Ciribiribin" with Benny Goodman 1939 | Chuck Par-Due
Daydream Believer | The Monkees
A Moment Apart | ODESZA
It's Been a Long, Long Time | Kitty Kallen
2112: Overture / The Temples Of Syrinx / Discovery / Presentation / Oracle / Soliloquy / Grand Finale (Medley) | Rush
20:34 | Lucky Chops - Memories (Studio Video)
Lucky Chops - Memories (Studio Video) | Lucky Chops
Neal Hefti - Girl Talk | Easy Library
Count Basie Orchestra-Cute | MÃ¡tyÃ¡s Papp
windows sound effect (acapella) | MayTree
Harry James - Trumpet Blues & Cantabile | Renato
Stan Getz & Joao Gilberto - The Girl From Ipanema | Stan Getz
drivers license (Official Video) | Olivia Rodrigo
Kodo | Yoshida Brothers
Bill Evans Trio - Emily (Helsinki 1969) | symbolkid
Hadal Ahbek | Issam Alnajjar
In the Air Tonight | Phil Collins
(I Just) Died In Your Arms (Official Music Video) | Cutting Crew
Coleman Hawkins' All Star Octet - The Sheik Of Araby | Heinz Becker
Baman and Piderman-You Can Do the Thing Full Song and Dance | Rusty Nails34
here comes the sun | Bill Wurtz
Joe Hisaishi - Summer | Joe Hisaishi
One Summer's Day (from 'Spirited Away') | Joe Hisaishi
All Along The Watchtower (Official Audio) | The Jimi Hendrix Experience
Harold Faltermeyer - Axel F (1984) Beverly Hillsï»¿ Cop - Soundtrack | DiscoBar80
bass guy VS bald guy | Davie504
When Your Clap Game Is On Another Level | Kevon Carter
Another Day of Sun - La La Land (Original Motion Picture Soundtrack) | VÃ­ctor Hugo
So This Is Love: Waltz | Mack David
Peter Pan - Main Title Music (The Second Star to the Right) | Sam Novak
Nat King Cole "Smile" (1954) | Mark Parker
Running Outta Love (feat. Tori Kelly) | Jacob Collier
Count the People (feat. T-Pain & Jessie Reyez) | Jacob Collier
Los Lobos ft. Arturo Sandoval - Walk don't Rango | Yamasuba
Maynard Ferguson - Give It One | malawolf85
Maynard Ferguson Big Band LIVE 1982. 02. Hollywood - better quality | Vilibattya
Wolf Totem (Official Music Video) | The HU
Days of Wine and Roses ï¼‹1 / Dizzy Gillespie | knuckletc
Arthur Miles "Lonely Cowboy" Parts 1 & 2 (Dallas, Texas, 1929) cowboy throat signing = Tuvan khoomei | Tim Gracyk
Yuve Yuve Yu (Official Music Video) | The HU
Mongolian Throat Singing With My Daughter | Batzorig Vaanchig
Chinggis khaanii Magtaal (Live) | Batzorig Vaanchig
MEUTE - You & Me (Flume Remix) | MEUTE
Somewhere Over The Rainbow | Israel Kamakawiwo'ole
I Don't Want To Set The World On Fire-The Ink Spots | renatikkio
Thank You Scientist - Mr. Invisible | Evil Ink Records
Jazz Music Korea - Autumn Leaves | Jazz Music Korea
Dave Brubeck - Take Five | buckinny
Wes Montgomery - Here's That Rainy Day -  Live London 1965 | saag111
Roy Hargrove - Strasbourg St. Denis (2007 New Morning Club) | ClassicalComposer
Airman ga Taosenai ("I Cannot Defeat Airman") English Subs, Re-translation and Karaoke. | Lazarus_DS
Joy Joy (feat. Brett Williams) | Kinga GÅ‚yk
Balding Lights (Official Video) | Davie504
Harder, Better, Faster, Stronger (feat. Swatkins) | Scary Pockets
Gangplank Galleon (Donkey Kong Country) Jazz Arrangement | Insaneintherainmusic
long long long journey | Bill Wurtz
Slow Down | Bill Wurtz
The Good Part | AJR
Three-Thirty | AJR
La Virgen de la Macarena | Rafael Mendez
Rafael Mendez - Flight of the Bumble Bee & Mexican Hat Dance | Zooter1940s
A Night in Tunisia (feat. Charlie Parker) | Dizzy Gillespie
Crescent | Anomalie
Velours | Anomalie
Funky Galileo | Sure Sure
I Bought Billie Eilish's Ukulele and Played It | Davie504
The Platters - Only You (And You Alone) (Original Footage HD) | Solrac Etnevic
Good Thing | Sure Sure
Good Thing | Sure Sure
Sure Sure - This Must Be The Place (Live) | Sure Sure
Dark Sheep | Chroma
Troubleman | Electric Guest
Twenty One Pilots - Shy Away (Official Video) | twenty one pilots
The Hype | twenty one pilots
Stressed Out | twenty one pilots
Teminite - Believe | Teminite
Thelonious Monk Quartet - 'Round Midnight | domtheodore
Man on the Moon (Orchestral) | R.E.M.
Wynton Marsalis recording "Abblasen" for CBS Sunday Morning | Wynton Marsalis
In Too Deep (feat. Kiana LedÃ©) | Jacob Collier
Make You Mine (Put Your Hand in Mine) [Official Video] | PUBLIC
Levitating (feat. DaBaby) | Dua Lipa
Don't Start Now | Dua Lipa
Knights of Cydonia | Muse
Hey Joe (Official Audio) | The Jimi Hendrix Experience
Wes Montgomery Trio - Days of Wine and Roses | 60otaku4
Wes Montgomery - Round Midnight | jazzytaka
A very talented guitar player! Just showing a trick he mastered. | Gustaf van Niekerk
You Give Love A Bad Name | Bon Jovi
Livin' On A Prayer | Bon Jovi
The Rubberband Man | The Spinners
September | Earth, Wind & Fire
Boogie Wonderland (Official Video) | Earth, Wind & Fire
Chet Baker - Tenderly | Coui0112358
Saria's Song (from Zelda: Ocarina of Time) (feat. Adam Neely) | The 8-Bit Big Band
Ryan Anthony performs GABRIEL'S OBOE at CancerBlows 2015 | CancerBlows
Ryan Anthony - Penny lane | CancerBlows
Unforgettable - Nat 'King' Cole | Sam Novak
Nat King Cole - Orange Colored Sky | Luar Furtado
Sonic Mania OST - Mirage Saloon Act 2 | Sonic the Hedgehog
Princess Leia's Theme | John Williams
La de da de da de da de day oh | Bill Wurtz
Cantina Band | John Williams
Laufey - I Wish You Love (Official Audio) | Laufey
Charles Trenet - Que Reste-T-il De Nos Amours | FePiu
Nat King Cole / I Wish You Love | JazzysCookie
Chet Baker - But Not For Me | betttyblue
It's The End Of The World As We Know It (And I Feel Fine) | R.E.M.
We Didn't Start the Fire (Official HD Video) | Billy Joel
"L' Amour Toujours" - STREET SAX PERFORMANCE | Daniele Vitale Sax
The Legendary NYC A-Train Sax Battle (Super Cut) | SilentHippo
Stan Rogers - The Mary Ellen Carter | MinistryofStabbing
Miles Davis Quintet - 'Round Midnight | 60otaku4
Getting Over It with Bennett Foddy Soundtrack | Soul & Mind - E's Jammy Jam | Thoprath Music
Bill Evans, 'Round Midnight | Levent Parman
The Freedom of Fretless Bass | Remco Hendriks
Miles Davis - Dear Old Stockholm | jazzhole13
Stevie Wonder - Sir Duke [HD] | ChEeZeBaLL999
Back in the Days | Mai Ligne
Stranger Things Theme Song (C418 REMIX) | recycle bin
Dizzy Gillespie - Bebop | Peruanas0
The First I love You | Kyle Dixon & Michael Stein
Things Can Only Get Better | Howard Jones
Can't Take My Eyes Off Of You | Frankie Valli
Saturday (Lyric Video) | twenty one pilots
Cant Take My Eyes Off You - Frankie Valli and The 4 Seasons + lyrics | MrMikeLyrical
Who Loves You (2006 Remaster) | Frankie Valli
December, 1963 (Oh, What a Night) [2007 Remaster] | Frankie Valli
Receive | Sure Sure
Careless Whisper (feat. Robyn Adele Anderson & Dave Koz) | Scott Bradlee's Postmodern Jukebox
Castaways (ft. Martina DaSilva and Rotem Sivan) | Adam Neely 2
At Your Mother's House | Rachael & Vilray
Amsterdam | Lately Lui
Stardust | Harry James
Say So (Japanese Version) | Rainych
Oscar Peterson Trio  & Clark Terry - Misty | All That Jazz Don Kaart
Nat King Cole - Autumn Leaves | PUNISHER6002
Super Mario World Ending Theme sight-read by Tom Brier | Keeper1st
Tom Brier plays Maple Leaf Rag in A, G, B, and as a waltz in B | Keeper1st
Beach Boys - Barbara Ann | beralts
California Girls (Stereo) | The Beach Boys
Howl's Moving Castle [OST - Theme Song] | ghibliggy
Friday I'm in Love | The Imaginary Trio
Nat King Cole "Just One Of Those Things" on The Ed Sullivan Show | The Ed Sullivan Show
Soul & Mind - E's Jammy Jam | William Robert
Nat king cole, Nature Boy | Hugo Marques
Someone In The Crowd | Emma Stone
A Lovely Night | Ryan Gosling
Plastic BASS | Davie504
One SLAP Man | Davie504
Hot Collie Bounce | WolfdogMusic
Clifford Brown & Max Roach - Joy Spring | Santoszzz
Clifford Brown & Max Roach - Joy Spring | Santoszzz
Milestones | Miles Davis
I Wish You Love | Laufey
Stay Alive | JosÃ© GonzÃ¡lez
The Hobbit: The Desolation of Smaug - Ed Sheeran "I See Fire" [HD] | Warner Bros. Pictures
Talk (Official Video) | Khalid
The lion sleeps tonight but itâ€™s uncomfortable | MisterSenpaii
Alone | Marshmello
Take It Back | Marshmello
still feel. | halfÂ·alive
Blueberry Eyes | MAX
Heat Waves (Official Video) | Glass Animals
Install Linux instead of Windows 11 - Here's how! | Linus Tech Tips
Sunkissed | khai dreams
good 4 u (Official Video) | Olivia Rodrigo
Rex Stewart - I'm True To You | JazzinJive
Nick Travis-Tenderly w Elliot Lawrence Big Band 1950's | JJ Martin
Desafinado | JoÃ£o GIlberto & Stan Getz
Chet Baker and the Lighthouse All-Stars - At Last | 60otaku4
At Last | Miles Davis
Summerland (Official Video) | halfÂ·alive
Ella Fitzgerald & Louis Armstrong - The Nearness Of You | Aristo07
Frank Sinatra - I'll Be Seeing You 1944 Tommy Dorsey & His Orchestra | ScrambledEggs1969
Frank Sinatra Harry James Orchestra  "All or Nothing at All" | catman916
Sleepy Lagoon | Harry James
"Potato Head Blues" Louis Armstrong & His Hot Seven on Okeh 8503 recorded May 10, 1927 | Tim Gracyk
Clifford Brown - "Stardust" | SpatialBlues
Clifford Brown - Smoke Gets In Your Eyes | Lalo CabaÃ±as
Clifford Brown - Embraceable You | LuigiRuscello
JUJUTSU KAISEN - Ending | Lost in Paradise feat. AKLO | Crunchyroll
japanese jazz when driving on a warm night | tardiobscurus
Ginger Root - "Loretta" (Official Music Video) | Ginger Root
Louis Armstrong - Hello Dolly | Austin Casey
They GAVE Me A Grand Piano... Here's me playing it | Charles Cornell
Junko Ohashi - I Love You So | Noah Gonzalez
Taeko Ohnuki - 4:00 AM - 1978 | TheAmuseum
Let You Break My Heart Again | Philharmonia Orchestra
Harry james - Trumpet Blues 1944 With original stereo movie soundtrack | Vas-Schwarcz GÃ©za
Chet Baker - Almost blue | Sweetydu972M
Chet Baker - I Wish You Love | pelodelperro
Miles Davis Quintet - It Never Entered My Mind | 60otaku4
Gerry Mulligan - Night Lights (1963) | Buteco do Pixinga
nat king cole  caravan | marlondavis1000
That Old Feeling / Chet Baker | hk613
Grover Washington Jr. feat. Bill Withers - Just The Two of Us [HQ] | Claudinho Viana II
Danza 2016 | Lucky Chops
It's Not Goodbye | Lucky Chops
Liftoff | Andrew Huang
The Hill | Andrew Huang
The Cruel Angel's Thesis (Director's Edit Version) | Yoko Takahashi
Trains    (by Blue Note Tokyo All star Jazz Orchestra)w/Peter Erskine,  Bob James,  Eric Miyashiro | Eric Miyashiro
ä¸­åŸã‚ã„ã“ Nakahara Meiko - Fantasy | LazySundayPlans
å…‰ã‚‹ãªã‚‰ï¼Goose house | Goose house
é«˜å¶ºã®èŠ±å­ã•ã‚“ï¼back number ï¼ˆCoverï¼‰ | Goose house
The Lion Sleeps Tonight | The Tokens
Acapella Soul - The Lion Sleeps Tonight | TJIMC
You Made Me Love You - Harry James / Helen Forrest | iTubeNL
Just The Two Of Us but it's on BASS | Davie504
Taking the caffeine out of Red Bull so I can drink it at night | NileRed
Quake Theme | Nine Inch Nails
Louis & Ella - Dream A Little Dream Of Me (HD) | JazzMusicHD
Yakuza OST - Baka Mitai (ã°ã‹ã¿ãŸã„) Kiryu full version | Senshi Ongaku
Billie Holiday & Louis Armstrong - New Orleans | bessjazz
Super Mario Odyssey - Jump Up, Super Star! | MuttonBashers
MEUTE - Hey Hey (Dennis Ferrer Rework) | MEUTE
Yasuha (æ³°è‘‰) - Flyday Chinatown ãƒ•ãƒ©ã‚¤ãƒ‡ã‚£ãƒ»ãƒãƒ£ã‚¤ãƒŠã‚¿ã‚¦ãƒ³ ã‚«ãƒãƒ¼ | Fujii Kaze
Everytime We Touch Lyrics | KyoSohmaCat101
Skate | Anderson .Paak
Skate | Anderson .Paak
The Doobie Brothers: What A fool Believes (1979) Classic Rock R&B, and Pop | 2chann
Last Train Home - Pat Metheny Group | cascade6060
Growing Pains | Tommy Lehman
The Platters - The Great Pretender (Original Footage HD) | Solrac Etnevic
The Platters - Smoke Gets In Your Eyes | OldManCrankyCane
Stan Rogers - Northwest Passage | MoonfirespamAM
Ben E. King - Stand By Me (Audio) | Soulful Sounds
Stan Rogers - Barrett's Privateers | bytor21122112
Ella & Louis - Cheek to Cheek | enayat
Artie Shaw  - Beguin The Beguine ( Cole Porter ) | Arnold Beltran
Clementine - Jean Goldkette & His Orchestra (w Bix Beiderbecke) (1927) | Atticus Jazz
Singin The Blues - Bix Beiderbecke | fskeptical
Cat Anderson El Gato | Geoff Winstead
Glenn Miller - In The Mood [HQ] | symir547
Feels So Good | Chuck Mangione
Chet Baker "Let's get lost" | Beatriz
Gerry Mulligan Quartet with Chet Baker - Stardust | ldowat
Abusey Junction | Kokoroko
Mayonaka no Door / Stay With Me | Miki Matsubara
Fleetwood Mac - Dreams [with lyrics] | muzicchnl
Higher Ground (feat. Naomi Wild) | ODESZA
Ella F. and Louis Armstrong - Let's Call the Whole Thing Off | Irracional182
More Than A Dream | Bill Wurtz
Rolling Down The Street, In My Katamari | Fearofdark
Peace of Mind (Official Audio) | Boston
Anarchy - Calio (FitMC Anarchy Collection) | notcalio
Boston - More Than A Feeling (HQ) | The Match Me Podcast
Blue Mitchell Quartet - I'll Close My Eyes | 60otaku4
Hey Ya! (Official HD Video) | Outkast
Monty Python and the Holy Grail- Intermission Music | Slycovian
Ray Charles   I Can't Stop Loving You | HK
Plastic Love | Mariya Takeuchi
Put On A Smile | Bruno Mars
Upside Down | JVKE
Okinawa | 92914
5:49 | Fire In The Sky
Fire In The Sky | Anderson .Paak
Fly As Me | Bruno Mars
The Flamingos - I Only Have Eyes For You | TahoeThom
Everybody Loves Somebody (Official Audio) | Dean Martin
how deep is your love l cover (ENG SUB) | ARO
The Drifters - Under the Boardwalk | Bees Knees Oldies
the Drifters There Goes my Baby | Alan C
Port City Sound performing during a flight delay! | Kari Mann
Blinding Lights (Official Audio) | The Weeknd
Pigstep (Stereo Mix) | Lena Raine
Days Of Wine And Roses | Dizzy Gillespie
Dean Martin - That's Amore | NM Catalogue
I Don't Want to Set the World on Fire | The Ink Spots
Peaceful In My Mind | Sure Sure
Donkey Kong Rap | ChangoDeGuerra
Bob Marley - Is This Love | Reggae Life
Bob Marley - Stir it up | BoBMArleySong1
Love Nwantiti (Acoustic Version) | CKay
The Rain | Joe Hisaishi
Ashitaka and San | Joe Hisaishi
Initial D - Deja Vu | Pretty ok
Autumn Leaves - Chet Baker & Paul Desmond Together | Brunex Barrios
I Like Me Better | Lauv
Paris in the Rain | Lauv
John Mayer - Neon (Live In LA - 1080p) | Paul Kellerman
When I Fall In Love | Nat King Cole
The Very Thought Of You | Nat King Cole
You were there -Al Bowlly 1936 | Blank Canvas Indie Films
Munx Gregoriana - Halo Theme Song LIVE chant in a BIG Echo Chapel | Halo Infinite Tribute | Game Music Collective
Halo Theme Song - Gregorian Ensemble sings in a Church [LIVE - BIG Echo] Halo Infinite Tribute | Munx Gregoriana
Autumn Leaves | Cannonball Adderley
Ray Charles - Hallelujah I Love Her So (1955) | ChorchWorld
Whitesnake - Is This Love | 80sclassicrocksongs
Eye Of The Tiger (Official HD Video) | Survivor
Is This Love (Video) | Survivor
Separate Ways (Worlds Apart) (Official HD Video - 1983) | Journey
Don't Stop Believin' (Official Audio) | Journey
Across The Universe (Remastered 2009) | The Beatles
Something | The Beatles
Super Smash ğŸ¹ | Anomalie
Let It Be (2021 Mix) | The Beatles
Please Mister Postman (Remastered 2009) | The Beatles
The Marvelettes - Please Mr. Postman (1961) | ticktock70
The Music of Cuphead - The Delicious Last Course: Recording the â€˜Overtureâ€™ | Studio MDHR
Persona 4 Golden - Shadow World Full version w/ Lyrics | Logan Starz
Island Ding (STOP POSTING ABOUT DONKEY KONG full song) | Udge
The Mystic Crystal | Ninja Sex Party
Worlds Hardest Tenor Solo | TDDrummer
Maynard Ferguson - Gonna fly now - Mike Douglas Show 1977 | 4greatmf
Ray Anthony & His Orchestra - What's New (Capitol Records 1960) | RoundMidnightTV
Ray Anthony & His Orchestra â€“ All Anthony And No Cleopatra/Mr. Anthonyâ€™s Boogie | Pavel Voronin
Stevie Wonder I Just Called To Say I Love You | no
Break My Heart | Dua Lipa
LC Full Blast (Live) | Lucky Chops
Pineapple | Engelwood
Two Oruguitas (From "Encanto"/Audio Only) | SebastiÃ¡n Yatra
Come Running to Me | Anomalie
Dos Oruguitas (From "Encanto"/Lyric Video) | SebastiÃ¡n Yatra
Aimer - ã‚«ã‚¿ã‚ªãƒ¢ã‚¤ / THE FIRST TAKE | THE FIRST TAKE
Finesse (remix) (feat. Cardi B) | Bruno Mars
Fly As Me (LIVE BET Soul Train Awards 2021) | Bruno Mars
Halfway to the Hudson | Lucky Chops
Soytiet - 41 [Official Music Video] | Retro Messiah
Falling In Love With Love / CLIFFORD BROWN MEMORIAL | MINICQQPER
Grubhub Sound Bites: Anderson .Paak + The Free Nationals | Anderson Paak
Come On Eileen | Dexys Midnight Runners
Four | Jazzman 2696
Night Lights | Gerry Mulligan Sextet
Freeway | Gerry Mulligan Quartet
Darn That Dream | Gerry Mulligan Quartet
Just the Two of Us (feat. Bill Withers) | Grover Washington, Jr.
I Think I Like When It Rains | WILLIS
Portside Sound Session: WILLIS - "27 Reasons" | Portside Sound Studios
Manteca - Dizzy Gillespie | Louis Rodrigues
Santo & Johnny "Sleep Walk" | NRRArchives
Something About You | Boston
More Than a Feeling | Boston
Blue Mitchel - I'll close my eyes | iichiroiichiro
The Bass Walk: Abraham Laboriel | Boyd Matson
Incredible Victor Wooten solo bass jam | MusicRadar
It's A Love Thing - The Whispers | maumau1968
City of Stars - Laufey (La La Land cover) | Laufey
Everybody Wants to Rule the World (feat. Cory Henry) | Scary Pockets
Wireless led  | How to make wireless led at home | Room Engineer
Dave Brubeck - Koto Song | Tori Chitic
Chan Chan | Buena Vista Social Club
Traveler II: The Path | Lucky Chops
Full Heart Fancy | Lucky Chops
Funk No.1 - TOKYO GROOVE JYOSHI | Juna Serita
Oscar Peterson - Hymn To Freedom | dgbailey777
KAMAUU - MANGO (feat. Adi Oasis) [Official Music Video] | KAMAUU
Driving to the banana store | Clayton Collins
Memoirs of a Geisha | John Williams and Yo-Yo Ma | Live | Dan Priest
Memoirs of a Geisha - Sayuri's Theme FULL | MsTiger16
Morrowind Theme Song | trooperV101
Earl Grant - The End (1958) | CatsPjamas1
miki matsubara-stay With Me | Epic Music
Rock With You (Official Video) | Michael Jackson
Everything I Know About Love | Laufey
Misty | Nat King Cole
[LIVE] Just the Two of Us - Jazz Music Korea | Jazz Music Korea
The Whispers - And The Beat Goes On (1979) | Andre Brown
Rock Steady | The Whispers
Love to Hate Me | BLACKPINK
Pretty Savage | BLACKPINK
FANCY | TWICE
TWICE DAHYUN "PROMISE (TWICE)" Vocal & Piano Cover | TWICE
Running in Real Time | Passport
The Chainsmokers - iPad (Guitar cover) | Gyoshi
Yubin "ìˆ™ë…€ (æ·‘å¥³)" M/V | JYP Entertainment
â€œë‚˜ë¡œ ë°”ê¾¸ì Switch to meâ€ by DAHYUN and CHAEYOUNG â€“ Melody Project | TWICE
Until I Found You | Stephen Sanchez
As It Was in the Live Lounge | BBCRadio1VEVO
Testa Rossa - Midnight Love | yotsu
Tomoko Aran - Midnight Pretenders (subtitled) | Mazori
Night Cruising | Momoko Kikuchi
MISSING U | TWICE
AS IF IT'S YOUR LAST -KR ver.- | BLACKPINK
AS IF IT'S YOUR LAST -KR ver.- | BLACKPINK
SOUL LADY | YUKIKA
Cherries Jubiles | YUKIKA
Neon | YUKIKA
Insomnia | YUKIKA
The Best Thing I Ever Did | TWICE
ONCE BEGINS, TWICE BEGINS "ONE IN A MILLION" | TWICE
Lovemonth | YUKIKA
Loving you | YUKIKA
Velours - Anomalie LIVE at Nexus ICA | Nexus Institute of Creative Arts
The Beach Boys - Surfer Girl | Stephen McElvain
LILAC | IU
strawberry moon | IU
Counting Stars (feat. Beenzino) | BE'O
GANADARA (feat. IU) | Jay Park
TWICE DAHYUN PIANO "Reminiscent(YIRUMA)" COVER | TWICE
Godâ€™s Menu | Stray Kids
Thunderous | Stray Kids
Kura Kura | TWICE
Victor Wooten - Isn't She Lovely | MÃºsicas
[IU's Palette] Did you block my number? (With Jay Park) Ep.11 | ì´ì§€ê¸ˆ [IU Official]
TRICK IT | TWICE
[MV] ìœ í‚¤ì¹´ (YUKIKA) - 'ì—¬ìì´ê³  ì‹¶ì€ê±¸ (loving you)' Official Music Video | ìœ í‚¤ì¹´ YUKIKA Official
ì½˜íŠ¸ë¼ë² ì´ìŠ¤ ìµœì¤€í˜_ì´íƒˆë¦¬ì•„ì—¬í–‰ ì¤‘ ê±°ë¦¬ì—°ì£¼ê°€ë“¤ê³¼ í•¨ê»˜ ì¦‰í¥ì—°ì£¼_Autumn leaves | Jazz Music Korea
Cinema Paradiso - Love Theme | Jazz Music Korea
Horace Silver - Song for My Father | jazzhole13
Mellow Dream | Noah Kawaguchi
æˆ‘æ„›ä½  | CodyLee
SHE IS SUMMERã€ŒCALL ME IN YOUR SUMMERã€ | SHE IS SUMMER
Dream in the Street | Noriyo Ikeda
Breakthrough | TWICE
DAHYUN MELODY PROJECT "Monsters (Katie Sky)" Cover by DAHYUN | TWICE
ì˜¤ëŠ˜ ë°¤ ë­í•´? (Whatâ€™re you doing tonight?) | YUKIKA
ì˜¤ëŠ˜ ë°¤ ë­í•´? (Whatâ€™re you doing tonight?) | YUKIKA
Sunset Road | Reiko Takahashi
Louis Armstrong - When It's Sleepy Time Down South | Austin Casey
I Fall In Love Too Easily | Chet Baker
Chet Baker / I'm Old Fashioned | Melancholy Rose
ONLY | Lee Hi
Lover Boy | Phum Viphurit
ì´í•˜ì´ (LeeHi) - [4 ONLY] Live Performance Day 1 (ENG) | AOMGOFFICIAL
ìŠ¤í…”ë¼ì¥ - ì•„ë¦„ë‹¤ì›Œ (ë””ê¹…í´ëŸ½ì„œìš¸ver.) MV | ì˜¨ìŠ¤í…Œì´ì§€ONSTAGE
Cherries Jubiles | YUKIKA
Ginger Root - "Loneliness" (Official Music Video) | Ginger Root
Yesterday | YUKIKA
Without You â€œAudioâ€ (feat. Sandro Cavazza) | Avicii
[MV] ìœ í‚¤ì¹´ (YUKIKA) - í–¥ê¸° (Scent) / Official Music Video | SEOUL MUSIC / ì„œìš¸ë®¤ì§
Machi No Dorufin | Kingo Hamada
You're Right (feat. Kingo Hamada) | Yoon Jong Shin
Forbidden Game | Yoon Jong Shin
A Day for Love | YUKIKA
SHADE | YUKIKA
Meta Knight's Revenge (From "Kirby Superstar") (feat. Button Masher) | The 8-Bit Big Band
Still Alive (From "Portal") | The 8-Bit Big Band
Lonely Rolling Star (Katamari Damacy) | The 8-Bit Big Band
I FEEL LOVE | YUKIKA
A Day in the Life of a Dog Food Company - The Office US | The Office
Pass The Dutchie | Musical Youth
Ylang Ylang | FKJ
Ariana Grande - R.E.M. in the Live Lounge | BBCRadio1VEVO
[adult swim festival] thundercat--- them changes (feat. Ariana Grande , DOMI & JD Beck) | on1yariana
Ariana Grande - Them Changes (Thundercat cover) in the Live Lounge | BBCRadio1VEVO
pov (Official Live Performance) | Vevo | Ariana Grande
TIME TRAVEL | YUKIKA
Love in TV World | YUKIKA
Drive | Kim Areum
Fly-day Chinatown | Yasuha
Feel My Rhythm (Orchestra Version) | Seoul Philharmonic Orchestra
RUNNING OUT OF TIME | Tyler, The Creator
Midnight Cruisin' | Kingo Hamada
Running Up That Hill (acapella) | MayTree
ì£ ì§€-ì˜¤ëœë§Œì—(ë””ê¹…í´ëŸ½ì„œìš¸ver.) MV | ì˜¨ìŠ¤í…Œì´ì§€ONSTAGE
ë°ì´ë¸Œë ˆì´í¬ - ë„Œ ì–¸ì œë‚˜ (ë””ê¹…í´ëŸ½ì„œìš¸ver.) MV | ì˜¨ìŠ¤í…Œì´ì§€ONSTAGE
[ìµœì•  ì—”í„°í…Œì¸ë¨¼íŠ¸ ì„ ê³µê°œ] ìŠ¤íŠ¸ë ˆì´ í‚¤ì¦ˆ ì•„ì´ì—”ì˜ ë§ˆì„±ì˜ ë³´ì´ìŠ¤! ï¼œë™ë°± ì•„ê°€ì”¨ï¼ â™¬ | MBCentertainment
Camelia girl | Lee Mija
TAKE A CHANCE (Official) | Anderson .Paak
[ì˜¨ìŠ¤í…Œì´ì§€ ë””ê¹…í´ëŸ½ì„œìš¸2019] THEME01. ë°±ì˜ˆë¦° - ì–´ëŠ ìƒˆ(Original Song by ì¥í•„ìˆœ) | ì˜¨ìŠ¤í…Œì´ì§€ONSTAGE
Curious (Back to You X DAYBREAK, YUKIKA) | DAYBREAK
Tokyo Lights | YUKIKA
Gotta Get Back | Pink Sweat$
ìŒìƒ‰ìœ¼ë¡œ ì°¢ì€ ë…ë³´ì ì¸ ì¡´ì¬âœ¨ ì´í•˜ì´(LeeHi)ì˜ ã€ˆONLYã€‰â™¬ ì•„ëŠ” í˜•ë‹˜(Knowing bros) 298íšŒ | JTBC 210918 ë°©ì†¡ | ì•„ëŠ”í˜•ë‹˜ Knowingbros
SAY SOMETHING | TWICE
MOONLIGHT | TWICE
just the two of us | Jazz Music Korea
Tenderly - Jazz Music Korea | Jazz Music Korea
Dance the Night Away | TWICE
NAKKA (feat. IU) | AKMU
Dinosaur | AKMU
Aimerã€Œæ®‹éŸ¿æ•£æ­Œã€MUSIC VIDEOï¼ˆãƒ†ãƒ¬ãƒ“ã‚¢ãƒ‹ãƒ¡ã€Œé¬¼æ»…ã®åˆƒã€éŠéƒ­ç·¨ã‚ªãƒ¼ãƒ—ãƒ‹ãƒ³ã‚°ãƒ†ãƒ¼ãƒï¼‰ | Aimer
Looney Tunes (acapella) | MayTree
Super Smash Bros. Brawl (acapella) | MayTree
TAKE A CHANCE | DOMi & JD BECK
After this night | KIM A REUM
Ray Charles   Moonlight in Vermont | laszlokrempels
It's Beautiful | Stella Jang
[MV]'ì¹˜ì—´(Cheers) (with ELLE KOREA)' ìœ¤ê³„ìƒ,ë¬¸ê°€ì˜ ì£¼ì—° & ì½”ë“œ ì¿¤ìŠ¤íŠ¸, AKMU ì´ì°¬í˜, ì½œë“œ, ì†Œê¸ˆ [RECONNECT 2021] *Official* | ì—˜ë¥´ ì½”ë¦¬ì•„_ELLE KOREA
Shining Road | Sultan Of The Disco
ë¯¸ë…¸ì´X10CM, ì„œë¡œ ë…¸ë˜ë¥¼ ë°”ê¿” ë¶€ë¥¸ë‹¤ë©´? í°ì„œíŠ¸, DOOL, Tea time ë“± | [Acoustic LIVE] meenoi, ì‹­ì„¼ì¹˜ | Dingo FreeStyle
ë¯¸ë…¸ì´ê°€ ëŒ€í•™ ê°ˆ ë•Œ ë¶€ë¥¸ ë…¸ë˜! ëŠë‚Œ ì•Œì§€? 'Cheek to Cheek' ë¼ì´ë¸Œ | meenoi's 'Cheek to Cheek' Live & Interview | ì—˜ë¥´ ì½”ë¦¬ì•„_ELLE KOREA
ë¯¸ë…¸ì´ì˜ ì˜ë„ì  ê·€ì—¬ì›€! 'ëª»ì°¸ì•„!(feat.ë¡œê¼¬)' ë¼ì´ë¸Œ | meenoi's 'I can't wait' Live & Interview | ì—˜ë¥´ ì½”ë¦¬ì•„_ELLE KOREA
Hey Jude [blank] | The Beatles
Eternal Sunshine (feat. meenoi) | GRAY
[EN/JP] [#ê³ ë“±ë˜í¼4/9íšŒ] ë°•í˜„ì§„ - PARADISE (Feat. meenoi) @ ì„¸ë¯¸íŒŒì´ë„ | Mnet 210416 ë°©ì†¡ | Mnet TV
Song Sohee - Tomorrow | ì†¡ì†Œí¬ - ë‚´ì¼ [Immortal Songs 2] | KBS WORLD TV
meenoi (ë¯¸ë…¸ì´) - [Tea time (Feat. 10CM)] Official M/V | 8BallTown
TEA FOR TWO (1957) by Nat King Cole - two different versions | wilson mcphert
Orange Road (with YUKIKA) (feat. YUKIKA) | Bronze
ë¡œê¼¬ (Loco) - 'ì´ëŒ€ë¡œë§Œ (feat. george) | Loco
[4K] ë¡œê¼¬(Loco) - â€œì´ëŒ€ë¡œë§Œ (Just Like This)â€ Band LIVE Concert â”‚ê°ì„± ë˜í¼ ë¡œê¼¬ì˜ íë§ ì‹ ê³¡ğŸ’– [itâ€™s KPOP LIVE ì‡ì¸ ë¼ì´ë¸Œ] | it's Live
[4K] ìœ ì£¼(YUJU) â€œì´ë¸Œë‹(Evening feat.ë¹…ë‚˜í‹°)â€ Band LIVE Concert ì—¬ë¦„ ë°¤ì— ê³„ì† ë“£ê³ í”ˆ ë°´ë“œë¼ì´ë¸Œ [itâ€™s KPOP LIVE ì‡ì¸ ë¼ì´ë¸Œ] | it's Live
Moonlight Serenade | Glenn Miller & His Orchestra
Duke Ellington, "Take the A Train" | morrisoncoursevids
Song So Hee(ì†¡ì†Œí¬) - Spring Day(ë´„ë‚ ) (Immortal Songs 2) I KBS WORLD TV 201114 | KBS WORLD TV
Valentine | Laufey
Valentine | Laufey
[flâ–¶ï¸ylist] 'ç«¹å†…ã¾ã‚Šã‚„(Takeuchi Mariya)- Plastic Love' cover by í•˜ì˜ | fromis_9
LAST WALTZ | TWICE
DM | fromis_9
Stay This Way | fromis_9
ãƒãƒªã‚ªã‚«ãƒ¼ãƒˆ8 è¿½åŠ ã‚³ãƒ³ãƒ†ãƒ³ãƒ„ç¬¬2å¼¾ ãƒ“ãƒƒã‚°ãƒ–ãƒ«ãƒ¼BGM | Nintendo å…¬å¼ãƒãƒ£ãƒ³ãƒãƒ«
ãƒãƒªã‚ªã‚«ãƒ¼ãƒˆ8 è¿½åŠ ã‚³ãƒ³ãƒ†ãƒ³ãƒ„ç¬¬2å¼¾ ãƒªãƒ³ãƒªãƒ³ãƒ¡ãƒˆãƒ­BGM | Nintendo å…¬å¼ãƒãƒ£ãƒ³ãƒãƒ«
Feel Good (SECRET CODE) | fromis_9
[4K] í”„ë¡œë¯¸ìŠ¤ë‚˜ì¸(fromis_9) â€œDMâ€ Band LIVE Concert ì¢‹ì•„í•´ ë‚œ í”„ë¡œë¯¸ìŠ¤ë‚˜ì¸ë§Œì„ğŸ’‘ [itâ€™s KPOP LIVE ì‡ì¸ ë¼ì´ë¸Œ] | it's Live
In my room (Interlude) | meenoi
[4K] í”„ë¡œë¯¸ìŠ¤ë‚˜ì¸(fromis_9) â€œí•œ í˜ì´ì§€ê°€ ë  ìˆ˜ ìˆê²Œ (by DAY6)â€ Band LIVE Concert ì²­ì¶˜ì€ ë°”ë¡œ í”„ë‚˜ğŸ’› [itâ€™s KPOP LIVE ì‡ì¸ ë¼ì´ë¸Œ] | it's Live
TWICE 'CRY FOR ME' Choreography - 2 | TWICE
ğŸŒ¿ê°€ì•¼ê¸ˆê³¼ ì œì¼ ì˜ì–´ìš¸ë¦¬ëŠ” ê³¡ 'ì¸ì—°' ê°€ì•¼ê¸ˆ ì»¤ë²„ Korea instrument Gayageum cover BY.YEJI | YEJIgayageum_ê°€ì•¼ê¸ˆì˜ˆì§€
ğŸ¬ì—¬ë¦„ì— ë“£ëŠ” í•„ìˆ˜ê³¡ SUMMER - íˆì‚¬ì´ì‹œì¡° ê°€ì•¼ê¸ˆ ì»¤ë²„ ì—°ì£¼ ë“£ê¸° Korea instrument Gayageum cover BY.YEJI | YEJIgayageum_ê°€ì•¼ê¸ˆì˜ˆì§€
for lovers who hesitate | JANNABI
I Love You So | The Walters
ì•Œê³  ì‹¶ì§€ ì•Šì•„ (REWIND) | TWICE
[ì¹´íŠ¸ë¼ì´ë”] AKMU ì–´ë¹„ìŠ¤ í…Œë§ˆì†¡ Drift_MV | í¬ë ˆì´ì§€ë ˆì´ì‹± ì¹´íŠ¸ë¼ì´ë”
Always and Forever (from Always and Forever: An Evening of So... | Luther Vandross
TWICE Performs 'Talk That Talkâ€™ | #MTVFreshOut | MTV
Harry Styles - Boyfriends / THE FIRST TAKE | THE FIRST TAKE
Airplane Mode | fromis_9
Just Like Chet | Laufey
Starry night | fromis_9
TWICE "Talk that Talk" Performance Video | TWICE
Basics | TWICE
Arturo Sandoval 'Here's That Rainy Day' | Live Studio Session | KNKX Public Radio
í”„ë¡œë¯¸ìŠ¤ë‚˜ì¸ (fromis_9) 'flaylist' 'Officialé«­ç”·dism - Pretender' cover by í•˜ì˜ | fromis_9
Gone | TWICE
í•œìˆ¨(Breathe) | LeeHi
ì˜¤ì„ì¤€ ì¥í•„ìˆœ ë°•ì •ìš´ - ë‚´ì¼ì´ ì°¾ì•„ì˜¤ë©´ | ejj207
ì†¡ê³¨ë§¤ = ì–´ì©Œë‹¤ ë§ˆì£¼ì¹œ ê·¸ëŒ€ | osinine
Day & Night (feat. Jay Park) (ë‚® ë°¤ (feat. Jay Park) | Lee Young Ji
Mayday (feat. JOY) | Crush
Valentine | Laufey
The Otter | Caamp
Landline | binki
Back Porch Sessions: CAAMP | Garden & Gun Magazine
EVERYTHING | The Black Skirts
Bill Evans "Peace Piece" | William Repicci
Please never fall in love again (cover) | LANDOKMAI
Tsuki (Japanese Version) | LANDOKMAI
à¹à¸à¹‰à¸¡à¸™à¹‰à¸­à¸‡à¸™à¸²à¸‡à¸™à¸±à¹‰à¸™à¹€à¹€à¸”à¸‡à¸à¸§à¹ˆà¸²à¹ƒà¸„à¸£  - à¹€à¸‚à¸µà¸¢à¸™à¹„à¸‚à¹à¸¥à¸°à¸§à¸²à¸™à¸´à¸Š  (Official) | à¹€à¸‚à¸µà¸¢à¸™à¹„à¸‚ à¹à¸¥à¸° à¸§à¸²à¸™à¸´à¸Š
Flip Reset | Kaskade
Starry Night | Peggy Gou
à¸«à¸²à¸à¸ˆà¸°à¹€à¸à¸µà¸¢à¸‡à¸‚à¸­ (Sincare) | PURPEECH
à¸ à¸²à¸à¸–à¹ˆà¸²à¸¢à¸§à¸±à¸™à¸§à¸²à¸™ (1920) | PURPEECH
à¸ˆà¸µà¸šà¸­à¸¢à¸¹à¹ˆà¹€à¸œà¸·à¹ˆà¸­à¹„à¸¡à¹ˆà¸£à¸¹à¹‰ (How Cute!) | WWJ
à¸•à¹ˆà¸­à¸ˆà¸²à¸à¸™à¸µà¹‰à¹€à¸à¸¥à¸‡à¸£à¸±à¸à¸—à¸¸à¸à¹€à¸à¸¥à¸‡à¸ˆà¸°à¹€à¸›à¹‡à¸™à¸‚à¸­à¸‡à¹€à¸˜à¸­à¹€à¸—à¹ˆà¸²à¸™à¸±à¹‰à¸™ | No One Else
à¸¥à¸¡à¸—à¸µà¹ˆà¸¥à¸² | YEW
Will I See You Again? | Thee Sacred Souls
Con La Miel En Los Labios (AcÃºstico / 2019) | Aitana
à¸™à¹‰à¸³à¸¥à¸²à¸¢ (feat. PEARWAH) | Txrbo
Say That You're Mine | JSO
I loved you | Shin Sae Byeok
To Me | Shin Sae Byeok
On The Sunny Side Of The Street | Dizzy Gillespie
Dreamcatcher(ë“œë¦¼ìºì³) 'VISION' MV | Dreamcatcher
summertime | cinnamons
love never felt so good Michael Jackson cover | Sung Lee
How Deep Is Your Love (Live In Fort Lauderdale) | Jacob Collier
Telecaster Stripes (Capacity version) | Polkadot Stingray
[ìµœì´ˆê³µê°œ] Lauv (ë¼ìš°ë¸Œ) X ë¯¼ë‹ˆ ((G)I-DLE) - All 4 Nothing l @JTBC K-909 221015 ë°©ì†¡ | ê±¸ìŠ¤ ì˜¨ íŒŒì´ì–´ X KPOP JAMM
Star | fromis_9
Alice in Wonderland (feat. Philip Catherine) | Chet Baker
Alice in Wonderland OST - 01 - Main Title (Alice in Wondlerland) | disneysoundtrack89
Can I Call You Rose? | Thee Sacred Souls
Loveable | JO YURI
ì¡°ìœ ë¦¬ (JO YURI) - 'Blank' LIVE Clip [#OUTNOW ì¡°ìœ ë¦¬]ã…£ë„¤ì´ë²„ NOW. | ë„¤ì´ë²„ NOW.
Favorite Part | JO YURI
Autumn Memories (with Lee Seok Hoon) | JO YURI
Vagabond by CAAMP | Live Music recorded at The Campfire Sessions | The Campfire Experience
meenoi (ë¯¸ë…¸ì´) - ê·¸ë§Œí¼ë§Œ (faraway)ã…£Official M/V | 8BallTown
[ì˜¨ìŠ¤í…Œì´ì§€2.0] ì´ë£¨ë¦¬ - Dive | ì˜¨ìŠ¤í…Œì´ì§€ONSTAGE
à¹à¸à¹‰à¸¡à¸™à¹‰à¸­à¸‡à¸™à¸²à¸‡à¸™à¸±à¹‰à¸™à¹€à¹€à¸”à¸‡à¸à¸§à¹ˆà¸²à¹ƒà¸„à¸£ - à¹€à¸‚à¸µà¸¢à¸™à¹„à¸‚à¹à¸¥à¸°à¸§à¸²à¸™à¸´à¸Š live Farmtival â€¢à¸Ÿà¸²à¸£à¹Œà¸¡à¸•à¸´à¸§à¸±à¸¥ vol.1 à¸œà¸¥à¹„à¸¡à¹‰à¸«à¸£à¸£à¸©à¸² | What i like - à¸ªà¸´à¹ˆà¸‡à¸—à¸µà¹ˆà¸à¸¹à¸Šà¸­à¸š
ã‚°ãƒƒãƒ‰ãƒã‚¤ (feat. Asako Toki) | Asako Toki
ALL THE THINGS YOU ARE   -   Tadataka Unno | hotshiawase2
Could It Be I'm Falling in Love | The Spinners
Keep Cold | Numcha
à¸ à¸²à¸à¸–à¹ˆà¸²à¸¢à¸§à¸±à¸™à¸§à¸²à¸™ (1920) | PURPEECH
Song Sohee(ì†¡ì†Œí¬) - Fox Rain(ì—¬ìš°ë¹„) [Sketchbook / 2020.07.24] | KBS WORLD TV
Up And | fromis_9
Hype Boy | NewJeans
Yeah Yeah Yeah | BLACKPINK
The DJ is Crying for Help | AJR
ãƒ‡ãƒ¢æ¼”å¥ ã€å£¬ç”³ã®ä¹±ã€‘ by å·å£åƒé‡Œï¼è…æ²¼å­ä¸‰ï¼†å¤©åœ°é›…æ¥½ãƒ‰ãƒ©ãƒ ã‚³ãƒ³ãƒ†ã‚¹ãƒˆâ…¡ | Senri Kawaguchi
Kimienoikusa | Kairi Yagi
ì„ì¸ê±´ - ë°”ëŒì´ ë¶€ë„¤ìš”(Vocal. ë°•ì„±ì—°) | Jehan Kim
è¸Šã‚ã‚ˆã€ãƒ•ã‚£ãƒƒã‚·ãƒ¥ | Tatsuro Yamashita
Toshiki Kadomatsu - Hatsu Koi | Mixsensei
Chet Baker It Never Entered My Mind | Vito Marciello
Doesn't It All Sound Wonderful? | Yeju
Sleepless rainy night | IU
Playing with the Boys (Official Video - Top Gun) | Kenny Loggins
Cory Wong | KNKX Studio Session | KNKX Public Radio
Let Me Go | YONLAPA
Dirty Shoes | Numcha
San Francisco Street | Sun Rai
ILLELLA | MAMAMOO
Maxine Nightingale - Right Back Where We Started From | chinita41
meenoi (ë¯¸ë…¸ì´) - Cheek To Cheek | NOI MAS | Official LIVE | 8BallTown
Line by Line (feat. Paul Jackson Jr. & Cory Wong) | PREP
PREP - Cheapest Flight | MORindie
Turn The Music Up | PREP
Wouldn't Wanna Know | PREP
Years Don't Lie | PREP
Rain | PREP
GumshÃ¼ (feat. Charlie Hunter) | Cory Wong
Don't Look Back (feat. So!YoON! & Shownu) | PREP
So!YoON! (í™©ì†Œìœ¤) X Phum Viphurit â€˜Wingsâ€™ Official MV | SE SO NEON
ì¸„(Chuu)&ì£ ì§€(George) - 'Dear My Winter' | ë¡¯ë°ë°±í™”ì 
Ripe Aster | Kairi Yagi
åƒ•ã‚‰ã®æ°¸å¤œ | Kairi Yagi
Koi no Atoaji | Yufu Terashima
å…«æœ¨æµ·è‰ Special Live Performance | Kairi Yagi
Shigeki ni yoru Karera | Kairi Yagi
Bokuranoeiya | Kairi Yagi
DADALILA | Kairi Yagi
å…«æœ¨æµ·è‰ ã€ãŠèŒ¶ã§ã‚‚é£²ã‚“ã§ã€ | Kairi Yagi
[MV] ë¦¬ì˜¤ (RIO) - Shibuya | RIO
Among Us - Seek ğŸµ Original song for Hide n Seek | Innersloth
[MV] ë¬¸ë³„ (Moon Byul) - PRESENT | MAMAMOO
Geometry Dash (acapella) | MayTree
Super Mario Kart Music - Koopa Beach | supahmario1
Super Mario Kart Music - Rainbow Road | supahmario1
Mario Kart 7 Music - Main Theme / Title Screen | TherÃ³kMSM
ãƒãƒªã‚ªã‚«ãƒ¼ãƒˆ8 è¿½åŠ ã‚³ãƒ³ãƒ†ãƒ³ãƒ„ç¬¬1å¼¾ ãƒã‚¤ãƒ©ãƒ«ã‚µãƒ¼ã‚­ãƒƒãƒˆBGM | Nintendo å…¬å¼ãƒãƒ£ãƒ³ãƒãƒ«
mood indigo - Duke Ellington | wilo65
SANA MELODY PROJECT "Mood Indigo (CHEEZE)" Cover by SANA | TWICE
[flâ–¶ylist] 'å„ªé‡Œ(Yuuri)- ãƒ™ãƒ†ãƒ«ã‚®ã‚¦ã‚¹(Betelgeuse)â€™ cover by í•˜ì˜ | fromis_9
"Path of The Wind" by Joe Hisaishi | JakeGirnus
Yasuha - Flyday Chinatown | Musical Collection
ë‹¤ë¦¬ ê¼¬ì§€ë§ˆ (KíŒ ìŠ¤íƒ€ Live) | AKMU
Mong Mong | CodyLee
[YURI Playlist] Crush - ì–´ë–»ê²Œ ì§€ë‚´ (Cover by. ì¡°ìœ ë¦¬) | JO YURI
The Wind Forest | Joe Hisaishi
Suddenly | Yerin Baek
ë“œë¦¼ìºì³(Dreamcatcher)ì˜ â€œë°”ëŒì•„(Wind Blows) Band Ver.â€ â”‚ë“œìºì˜ ë°´ë“œë²„ì „ ë¬´ëŒ€ ë³´ëŸ¬ ë‚ ì•„ì˜¤ì‹¤ê²Œìš”~ğŸ•Šï¸  [itâ€™s KPOP LIVE ì‡ì¸ ë¼ì´ë¸Œ] | it's Live
Odd Eye | DREAMCATCHER
BEcause | Dreamcatcher
Whistle | Dreamcatcher
Fly high | Dreamcatcher
Odd Eye | Dreamcatcher
Scream | Dreamcatcher
BOCA | Dreamcatcher
REASON | Dreamcatcher
MAISON | Dreamcatcher
Starlight | Dreamcatcher
Silent Night (Silent Night) | Dreamcatcher
Jazz Bar (Jazz Bar) | Dreamcatcher
ë“œë¦¼ìºì³(Dreamcatcher)ì˜ â€œOdd Eye (Band Ver.)â€â”‚ì—¬ê¸°ê°€ ë“œìº ì˜¨ë¼ì¸ ì½˜ì„œíŠ¸ì¥ì¸ê°€ìš”? ì¶¤ê³¼ ë°´ë“œì˜ ì™„ë²½í•œ ì¡°í•©!  [itâ€™s KPOP LIVE ì‡ì¸ ë¼ì´ë¸Œ] | it's Live
Sukoyaka DE Itai | Kairi Yagi
[Special Clip] Dreamcatcher(ë“œë¦¼ìºì³) ì§€ìœ  'ì‚¬ê±´ì˜ ì§€í‰ì„ ' Cover | Dreamcatcher
Beauty Full (DAMI SOLO) | Dreamcatcher
íˆ¬ëª…í•œ ìŒìƒ‰ê³¼ ë°œë„í•¨ì´ ë‹ë³´ì´ëŠ” ì¡°ìœ ë¦¬(JO YURI)ì˜â™¬ 'GLASSY' | ë¹„ê¸´ì–´ê²Œì¸ ì˜¤í”ˆë§ˆì´í¬ | Beginagain ë¹„ê¸´ì–´ê²Œì¸
TWICE DAHYUN "ìƒˆë²½ í•˜ëŠ˜ì„ ë‹¬ë¦¬ë‹¤ (í•˜ì€ì§€/HA EUN JEE)â€œ Piano Cover - Video Editing by DAHYUN | TWICE
The Night | Frankie Valli & Frankie Valli
YOU AND I | Dreamcatcher
Can't get you out of my mind (Can't get you out of my mind) | Dreamcatcher
Elephant Gym on Audiotree Live (Full Session) | Audiotree
Ray Charles - Georgia On My Mind (The Orginal Song From The Albom) | tegavu1
Magic Moments (feat. Mitchell Ayres And His Orchestra & The Ray Charles Singers) | Perry Como
Sukoyaka DE Itai | Kairi Yagi
ã€å‰è¡›å¤ç®ã€‘Playing God - 43æ ¹å¼¦ä¹Ÿä¸å¤ æˆ‘é€ çš„ @Polyphia | å¢¨éŸµ Moyun Official
ã•ã‚‰ã°ã€ç§ã®æ˜Ÿ | Kairi Yagi
ë…¹ì•„ìš” Ice Cream | TWICE
You Wouldn't Know - Portal Big Band Jazz Version ft. Benny Benack III (The 8-Bit Big Band) | The 8-Bit Big Band
Setagaya-Daita | CodyLee
giant steps is not music.. | New Jazz Underground
123 | Sure Sure
Sure Sure | 4:00
Rewind | fromis_9
Escape Room | fromis_9
Cheese | fromis_9
Deja Vu (ë°ìë¶€ (Deja Vu)) | Dreamcatcher
One Summer's Day (from 'Spirited Away') | Joe Hisaishi
Ashitaka and San (Symphonic Suite "Princess Mononoke" / Live At Piano Stories '98 Orchestra Nights / 1998) | Joe Hisaishi
ç¾¤é’ / THE FIRST TAKE | Yoasobi
YOASOBI - å¤œã«é§†ã‘ã‚‹ [ãƒ™ãƒ¼ã‚¹] | Davie504
å„ªã—ã„å½—æ˜Ÿ / THE FIRST TAKE | Yoasobi
[MAD] Plastic Love - Mariya Takeuchi (Cover) | Millie Snow | MadpuppetStudio
Millie Snow - à¸­à¸¢à¸¹à¹ˆà¸„à¸™à¹€à¸”à¸µà¸¢à¸§à¸”à¹‰à¸§à¸¢à¸à¸±à¸™à¹„à¸«à¸¡ (Introvert) [Official MV] | Double Mass
[MAD] Lover Boy - Phum Viphurit (Cover) |  Millie & Cincin | MadpuppetStudio
Penny & The Quarters - You and Me | Alen TopliÅ¡ek
You and Me | Penny & The Quarters
Elephant Gym - Shell (Small Pond Session) | Small Pond
Dear Humans | Elephant Gym
æ˜¥é›¨ Spring Rain - Spring Rain | Elephant Gym
è½æ—¥é£›è»Š Sunset Rollercoaster â€“ My Jinji (Live from YuChen Studio) | CINEMAPHONIC Live Sessions
æ¤…å­æ¨‚åœ˜ The Chairs - æ¨¹å±‹ Tree House | CINEMAPHONIC SESSIONS | CINEMAPHONIC Live Sessions
Colors (Official Live Session) | Black Pumas
Go Through The Night | Elephant Gym
Wicked Man | Martin LandstrÃ¶m
é®å·éº»å¼¥ - é£ãŒè´ã“ãˆã‚‹æœ (HQ) | Forget The Rock Be Pop
å‡ºä¼šã£ã¦2åˆ†ã§æ‰“æ¥½å™¨ã®ãƒ—ãƒ­ã¨ã€ŒSpainã€å…±æ¼”ã—ãŸã‚‰ã€å…¬åœ’ãŒå¤§å–é‡‡ã«ãªã£ãŸï¼ã‚¹ãƒˆãƒªãƒ¼ãƒˆãƒ”ã‚¢ãƒ by Jacob Koller | Jacob Koller
å‡ºä¼šã£ã¦2åˆ†ã§ãƒˆãƒ©ãƒ³ãƒšãƒƒãƒˆã®ãƒ—ãƒ­ã¨å…±æ¼”ã—ãŸã‚‰ã€ã‚¨ãƒ¢ã„ãƒãƒƒãƒ—ã‚¹ã®æ›²ãŒé€”ä¸­ã‚¬ãƒƒãƒ„ãƒªã‚¸ãƒ£ã‚ºã‚»ãƒƒã‚·ãƒ§ãƒ³ã«ãªã£ãŸï¼ã‚¹ãƒˆãƒªãƒ¼ãƒˆãƒ”ã‚¢ãƒ by Jacob Koller | Jacob Koller
å‡ºä¼šã£ã¦2åˆ†ã§ãƒˆãƒ©ãƒ³ãƒšãƒƒãƒˆã®ãƒ—ãƒ­ã¨å…±æ¼”ã—ãŸã‚‰ã€ã‚¨ãƒ¢ã„ãƒãƒƒãƒ—ã‚¹ã®æ›²ãŒé€”ä¸­ã‚¬ãƒƒãƒ„ãƒªã‚¸ãƒ£ã‚ºã‚»ãƒƒã‚·ãƒ§ãƒ³ã«ãªã£ãŸï¼ã‚¹ãƒˆãƒªãƒ¼ãƒˆãƒ”ã‚¢ãƒ by Jacob Koller | Jacob Koller
You Always Hurt The One You Love - The Mills Brothers | HerkulTuberkul
Dion & The Belmonts : I Wonder Why | Mark Dale
SET ME FREE | TWICE
panaginip | iluna
Ditto | NewJeans
The Way You Look Tonight (2008 Remastered) | Frank Sinatra
I've Got Algorithm | Bijon Watson
Fairytale | Dreamcatcher
Jimmy Fallon, The Roots & The Super Mario Bros. Movie Cast Sing the Super Mario Bros. Theme Song | The Tonight Show Starring Jimmy Fallon
Cherry (Real Miracle) (JI U SOLO) | Dreamcatcher
Which a star | Dreamcatcher
Playground (GAHYEON SOLO) | Dreamcatcher
[Special Clip] Dreamcatcher(ë“œë¦¼ìºì³) ì§€ìœ , ìˆ˜ì•„ 'ë‚˜ë¡œ ë°”ê¾¸ì' Cover | Dreamcatcher
[Special Clip] Dreamcatcher(ë“œë¦¼ìºì³) í•œë™ 'ä¸‹é›¨å¤©'  Cover | Dreamcatcher
Come Home (feat. AndrÃ© 3000) | Anderson .Paak
Introvert (Japanese Version) | Millie Snow
à¸­à¹‹à¸­à¸„à¹ˆà¸° - Millie Snow x Earth Patravee (Cover)  | @EarthPatraveeMusic | Double Mass
Sunset (2019 Y.Nakamura Remastering) | BLU-SWING
BLU-SWING / FLASH | selectiverecords81
Direct Flyte (feat. Victor Wooten) | Cory Wong
Tokai | Taeko Ohnuki
MELTY / KAWAGUCHI MASAYO(1982) | BLAK SOLOMON
Jesus Molina live @ MÃ¼pa Budapest 2023 performing â€œHopeâ€ | JesÃºs Molina Music
ë¯¸ë…¸ì´ë‘ ë‹¨ ë‘˜ì´ ë…¸ë˜ë°©ì„ ê°€ë©´ ìƒê¸°ëŠ” ì¼ | [ë¯¸ë…¸ì´ì˜ ë…¸ì´ë˜ë°©] ë°”ë¨, ë†“ì•„ì¤˜, DOOL (with ì˜¤ë“œë§ˆì½”) | Dingo FreeStyle
Diamond (Diamond) | Dreamcatcher
We Ride | ë¸Œë ˆì´ë¸Œê±¸ìŠ¤
Coleman Hawkins & Ben Webster - It Never Entered My Mind | Santoszzz
Jimin: Like Crazy | The Tonight Show Starring Jimmy Fallon | The Tonight Show Starring Jimmy Fallon
The Mills Brothers  "Till Then" | catman916
I'll Be Around | The Mills Brothers
Smoke rings - The Mills Brothers | RiulDoamnei
Swing - Best of The Big Bands (1/3) | RPG Collection
The Legend of Ashitaka (Symphonic Suite "Princess Mononoke" / Live) | Joe Hisaishi
Tron Legacy - Soundtrack OST - 01 Overture - Daft Punk | Tron Legacy
Smoke Gets In Your Eyes - Coleman Hawkins | Snotty Gigglebutt
Fragments of Time (Official Audio) | Daft Punk
Love Never Felt So Good | Michael Jackson
The Look | Metronomy
Time of Our Life | DAY6
Hush Hush | fromis_9
Merry-Go-Round of Life (from â€œHowlâ€™s Moving Castleâ€) | Joe Hisaishi
The Legend of Ashitaka / Princess Mononoke (ã‚‚ã®ã®ã‘å§«ã‚ˆã‚Šã€Œã‚¢ã‚·ã‚¿ã‚«ã›ã£è¨˜ã€) (Shakuhachi / Piano Cover) | Ensemble Japan
Mack the Knife by Louis Armstrong | Bryan Galvez
When You're Smiling/The Sheik Of Araby (feat. Keely Smith & Sam Butera And The Witnesses) | Louis Prima
ä¹…çŸ³ è­² / Joe Hisaishi -- é¢¨ã®ã¨ãŠã‚Šé“ (HQ) | tennenkokekko
Misty - The Hi-Lo's | hardercorky
Bad Penny | Rory Gallagher
A Million Miles Away | Rory Gallagher
Merry Christmas, Mr Lawrence | Xuefei Yang
Merry Christmas Mr. Lawrence / Ryuichi Sakamoto - From Ryuichi Sakamoto: Playing the Piano 2022 | Ryuichi Sakamoto
Watashitachi o Shinjite Ite | Cindy
casiopea vs tsquare - fightman | KyungDong Lee
Nisemono | Ginger Root
Hear My Train A Comin' (Official Lyric Video) | Jimi Hendrix
Eclipse | Dreamcatcher
Stockholm Sweetnin' (with Swedish All Stars) (feat. Swedish All Stars) | Clifford Brown
But Not For Me (Instrumental) (feat. Russ Freeman) | Chet Baker Quartet
NDGGA | meenoi
Clara-Jumi Kang: Paganini, La Campanella (Arr. Kreisler) (Encore 2/3) | CJK Archive
Chloe Chua - Allegro-Capriccio from Locatelli's Harmonic Labyrinth | Singapore Symphony Orchestra
ã€ BLU-SWING / æº€ã¡ã¦ã„ãä½“æ¸© ã€‘LIVE at HARAJUKU QUEST HALL | selectiverecords81
YOGIJOGI | SUMIN & Slom
ë§ˆì¹˜-meenoi M/V | MEENOI
Smooth (Outro) | meenoi
Hurt | NewJeans
[4K] NewJeans(ë‰´ì§„ìŠ¤) â€œHurtâ€ Band LIVE Concert ìµœì´ˆë¡œ ê³µê°œí•˜ëŠ” ë‰´ì§„ìŠ¤ì˜ Hurt FULL ver.ğŸ’— [itâ€™s KPOP LIVE ì‡ì¸ ë¼ì´ë¸Œ] | it's Live
The Roots feat. Bilal: NPR Music Tiny Desk Concert | NPR Music
The BBQ Song - Rhett & Link | Rhett & Link
Newjeans(ë‰´ì§„ìŠ¤) í•˜ë‹ˆ X Colde(ì½œë“œ) - 'ì™€ë¥´ë¥´â™¥' | Newjeans HANNI X Colde - 'WA-R-R' | RYAN
[ë¦¬ë¬´ì§„ì„œë¹„ìŠ¤] EP.46 ë‰´ì§„ìŠ¤ í•˜ë‹ˆ | NewJeans HANNI | OMG, Just A Feeling, ì™€ë¥´ë¥´ â™¥, Lucky | KBS Kpop
Sparkle | Tatsuro Yamashita
å±±ä¸‹é”éƒã€ŒLOVELAND,ISLANDã€Special Clip (2002) | TATSURO YAMASHITA RCA/AIR Official YouTube Channel
The Legend of Zelda: Breath of the Wild - Theme (SoundTrack) | PeriÃ³dico de Hyrule
Dobie Gray - Drift Away (Original Official Video) | jeffreychristIsAlive
Dancing In the Moonlight | King Harvest
Blue Flame (2023 Ver.) | LE SSERAFIM
No-Return (Into the unknown) | LE SSERAFIM
FEARNOT (Between you, me and the lamppost) | LE SSERAFIM
Flash Forward | LE SSERAFIM
Fire in the belly | LE SSERAFIM
THE JAZZ AVENGERSã€ŒUniteã€ï¼ˆOfficial Music Videoï¼‰ | airgroove
Animal Crossing: New Horizons - Theme Song Performance - Nintendo Switch | Nintendo of America
Splatoon 3 â€“ Squid Sisters â€“ Wave Goodbye [In the Studio] â€“ Nintendo Switch | Nintendo of America
Tank! | Seatbelts
Werehog Battle Theme - Sonic Unleashed [OST] | DeoxysPrime
GOT THE THRILLS | TWICE
Tears of the Kingdom Main Theme 8-bit - The Legend of Zelda | Loeder
Hare Hare | TWICE
Chilled Chinese Noodles with Green Onion | CodyLee
MRCH Mood | MRCH
A Town with an Ocean View | Joe Hisaishi
Cupid cover | Sung Lee
Always cover | Sung Lee
[MV] LEE MU JIN(ì´ë¬´ì§„) _ Ordinary Confession(ì ê¹ ì‹œê°„ ë ê¹Œ) | LEE MU JIN
Cupid - Twin Ver. | FIFTY FIFTY
' B-SIDE (OT4) ' - LIVE IN STUDIO (Prod. SIAHN) | FIFTY FIFTY (í”¼í”„í‹°í”¼í”„í‹°) | FIFTY FIFTY
Valentine (Live at The Symphony) | Iceland Symphony Orchestra
BONVOYAGE (Farewell ver.) | Dreamcatcher
NIGHT DANCER | imase
BEHIND THE MASK | TWICE
'ìµœì´ˆ ê³µê°œ' ë“œë¦¼ìºì³ - BONVOYAGE #ì— ì¹´ìš´íŠ¸ë‹¤ìš´ EP.798 | Mnet 230525 ë°©ì†¡ | Mnet K-POP
Johnny B. Goode | Chuck Berry
Little Richard - Tutti Frutti | Darwinner
GANADARA Jay Park (feat. IU) cover | Sung Lee
Art Tatum -- Someone to Watch Over Me | eccentricXXX
HOW HIGH THE MOON   LES PAUL   MARY FORD   1951 | Sunday Funnies
Donâ€™t Start Now by Dua Lipa cover | Sung Lee
Linger Awhile (Visualizer) (feat. Pasquale Grasso) | Samara Joy
Guess Who I Saw Today | Samara Joy
[4K] ë“œë¦¼ìºì³(Dreamcatcher) â€œBONVOYAGEâ€ Band LIVE Concert ì„¸ê³„ê´€ ë§›ì§‘ ë“œìºì˜ ë°´ë“œë¼ì´ë¸ŒğŸ’— [itâ€™s KPOP LIVE ì‡ì¸ ë¼ì´ë¸Œ] | it's Live
Eve, Psyche & The Bluebeardâ€™s wife | LE SSERAFIM
After LIKE | IVE
Say Yes (Feels) (feat. Park Bird) | Ryce, Delanie, & DJ DENZ The Rooster
â€œMaking Wavesâ€ ft. Minnie of (G)I-DLE // VALORANT Champions Tour  Pacific 2023 | VALORANT Champions Tour Pacific
The Dumb Song | AJR
ç¦»äººæ„ | æè¢æ°
Attitude | fromis_9
#menow | fromis_9
Wishlist | fromis_9
In the Mirror | fromis_9
Don't Care | fromis_9
What I Want | fromis_9
My Night Routine | fromis_9
Eye Contact | fromis_9
My Famed Disappearing Act | Thank You Scientist
Prelude | Thank You Scientist
Gigglebutton | Thank You Scientist
Creature Comfort | Thank You Scientist
Thank You Scientist "Mr  Invisible" Sun Session | Sun Lab Studio
Thank You Scientist feat. Bluecoats - FXMLDR (Solar Powered Live Performance) | Thank You Scientist
Sugarcoat (NATTY Solo) | KISS OF LIFE
Tiwa Savage: Tiny Desk (Home) Concert | NPR Music
the plan | gigerth
world martial arts champion, spiderman | gigerth
NewJeans x J.I.D | Zero (Remix) | Coke Studio | Coke Studio
Zero (J.I.D Remix) | NewJeans
The Legend of Zelda: Tears of the Kingdom (acapella) | MayTree
Valerie cover | Sung Lee
Calm Down | Rema
Rema: Calm Down/Holiday | The Tonight Show Starring Jimmy Fallon | The Tonight Show Starring Jimmy Fallon
Idol | YOASOBI
REALiZE | LiSA
NEVER GIVE UP YOUR WAAAAAAAAAAAAY | Team Psycosmos
Anchor | Thank You Scientist
Super Bell Hill (From "Super Mario: 3D World") | The 8-Bit Big Band
Sayonara Natsu No Hi | Tatsuro Yamashita
My sense of humor is broken | f4iry
'Apparently' kid interviewed at Pennsylvania county fair | CBS 42
Super Shy | NewJeans
High On A Rocky Ledge | Moondog
New Amsterdam | Moondog
Himiko Kikuchi - Flying Beagle (1987) | captain chef
Groovin' (Single Version) | The Young Rascals
YOUR NEW MORNING ALARM | Marc Rebillet
JID: Tiny Desk Concert | NPR Music
Serani Poji - Pipo Pipo | san boogie
Serani Poji - Time is Flowing Slowly | (;Â´ï½¥Ï‰ï½¥)
Serani Poji - Sugar Boo | mirroredhour
OUTTA MY MIND | Monsune
Blue Train (Remastered 2003/Rudy Van Gelder Edition) | John Coltrane
Get Up | NewJeans
Cool With You | NewJeans
åŒ—ä¸Šã®ã‚¹ã‚¹ãƒ¡ | Necry Talkie
Last Summer Whisper | Anri
Iâ€™m in Love | Yerin Baek
Hiromi Uehara The Trio Project "Desire" | Hiromi Uehara
Mai Yak Fung | Serious Bacon
Remember Summer Days | Anri
WINDY SUMMER | ANRI
CAT'S EYE | Anri
STAY BY ME | Anri
Kanashimi ga Tomaranai I CAN'T STOP THE LONELINESS | Anri
Let's Groove (Official HD Video) | Earth, Wind & Fire
Blame It On the Boogie (Official Video) | The Jacksons
Airport Lady - Toshiki Kadomatsu (1984) | Franky Mao
DRIVING MY LOVE | Anri
GOOD-NIGHT FOR YOU | Anri
Chingis Khaan | Batzorig Vaanchig
Looking Out for You (Lyric Video) | Joy Again
å±±ä¸‹é”éƒã€ŒSync Of Summerã€ | Warner Music Japan
Sukiyaki (Ue o Muite Arukou) - Kyu Sakamoto (English Translation and Lyrics) | Sugarfree
What Was I Made For cover | Sung Lee
Chilli Beans.  / DRIP TOKYO | DRIP TOKYO
Leon Theremin playing his own instrument | slonikyouth
Chet Atkins Dark eyes | boekenkas
ì§€êµ¬ê°€ íƒœì–‘ì„ ë„¤ ë²ˆ (Live) | IU
Hey Nineteen | Steely Dan
Fly By Day | Anri
Idol | Tim Henson
[meenoi] ìì‘ë© ì‡¼ë¯¸ë”ë¨¸ë‹ˆ9 ì§€ì›ì˜ìƒ | MEENOI
Idol Unplugged | Tim Henson
Seventeen | YOASOBI
Idol (Live) | YOASOBI
Johnny Rivers - Seventh Son. | cadlagh1 Bill Kealy
let it be summer | Young K
Mystical Composer | Momoko Kikuchi
Demon Dragon (Final Boss Phase 3) - The Legend of Zelda: Tears of the Kingdom OST | Yoshi's VGM
Saving Zelda (Final Dive) - The Legend of Zelda: Tears of the Kingdom OST | Yoshi's VGM
Colgera Wind Dungeon Boss Battle | Zelda Tears of the Kingdom Soundtrack | SitBar
Obongjayar: Tiny Desk Concert | NPR Music
Strangers | Kenya Grace
Almost Like Being In Love | Nat King Cole
[QUENMIX] NHÃƒ NHáº C VOL 5: CHIá»€U CHá»¦ NHáº¬T Vinyl Mixset by Jazz CÃ¡t LÆ°á»£ng | Weekend Vibe | QUá»†N
Roy Hargrove Quintet 'Top Of My Head' | Live Studio Session | KNKX Public Radio
Roy Hargrove Quintet 'Soulful' | Live Studio Session | KNKX Public Radio
People Make the World Go Round | The Monty Alexander Trio
Hiromi: Tiny Desk Concert | NPR Music
HAPPY END | Chilli Beans.
lemonade | Chilli Beans.
Itâ€™s ME | Chilli Beans.
Undron | Chilli Beans.
Generation | tripleS
Love Lee | AKMU
Fairytale | Dreamcatcher
Head Full Of Doubt/Road Full Of Promise | The Avett Brothers
V of BTS: Tiny Desk Korea | NPR Music
Turning NewJeans, SNSD, BTS & TWICE songs into JAZZ! (w/ Lee Jin Ah) | ReacttotheK
So Glad I Found You | Jalen Ngonda
If You Don't Want My Love | Jalen Ngonda
Popo (How deep is our love?) | Yerin Baek
[ENG SUB] ì´ì§„ì•„ 'ëŒíŒœíŒœ(Rum Pum Pum)' Live Performance | Lee Jin Ah 'Rum Pum Pum' | ì•ˆí…Œë‚˜ Antenna
Lee Jin Ah (ì´ì§„ì•„)  Dreamy Alarm (ê¿ˆ ê°™ì€ ì•ŒëŒ) JHMJams + behind the scenes | JHMJams
YOASOé¼» | ã¯ã‚‹ã‹2å·[æº–å‚™ä¸­]
ì´ì§„ì•„ ì •ê·œ 3ì§‘ 'ë„ì‹œì˜ ì†ë§ˆìŒ' : 'City Lights' Live Clip | Lee Jin Ah 3rd Full Album 'Hearts of the City' | Lee Jin-ah
[4K] AKMU(ì•…ë®¤) â€œLove Leeâ€ Band LIVE Concert ëŸ¬ë¸”ë¦¬í•œ ì°¬í˜&ìˆ˜í˜„ì˜ ë°´ë“œë¼ì´ë¸ŒğŸ’˜ [itâ€™s KPOP LIVE ì‡ì¸ ë¼ì´ë¸Œ] | it's Live
å‹‡è€… | YOASOBI
get him back! in the Live Lounge | BBCRadio1VEVO
DEMIAN (DEMIAN) | Dreamcatcher
Ditto | NewJeans
Christmas in June | AJR
my future Billie Eilish cover | Sung Lee
NAYEON "NO PROBLEM (Feat. Felix of Stray Kids)" Band Live Clip | NAYEON
The Way You Look Tonight | Oscar Peterson
Strasbourg /St. Denis (Roy Hargrove) êµ¬ë³¸ì•”xê¹€ìŠ¹í˜¸xìœ¤ì¤€í˜„xì ì¬ ì•¼ê°„í•©ì£¼ì‹¤ver. | ë¯¸ë¶„ë¥˜ì ì¬
Autumn Leaves | Vince Guaraldi
Fly Me To The Moon | Vince Guaraldi Trio
æŠ¹ä¸æ‰çš„æ€å¿µ (å¥³å£°ç‰ˆ) | é’°æŸƒ
å¼µç£Šç‰ˆã€Šå—å±±å—ã€‹ç¶“å…¸ç‰ˆMVï¼Œå¼ ç£Šã€Šå—å±±å—ã€‹MVã€‚ | èŠ±çš„æ—¥è®°
Transition å‰é€²æ¨‚åœ˜ Dui Bu Qi å°ä¸èµ·æˆ‘çš„ä¸­æ–‡ä¸å¥½ | transitionofficial
NOT OK (feat. ë¯¼ë‹ˆ) | Loco
Lemon Black Tea | JO YURI
[ì•¼ê°„í•©ì£¼ì‹¤] TWICE - 'Alcohol-Free' | ê³½ì§„ì–¸ & ì•”í˜¸ì¤€ì¬ì˜ ì¦‰í¥í•©ì£¼ ë¼ì´ë¸Œ! | ì•¼ê°„ì‘ì—…ì‹¤ | ë„¤ì´ë²„ NOW.
Jewelry | LE SSERAFIM
Tabber - Being (feat. ë°±ì˜ˆë¦°) (Official Video) | you.will.knovv
[ì•¼ê°„í•©ì£¼ì‹¤] ì´ë¬´ì§„ (Lee Mujin) - 'ê³¼ì œê³¡' ì¦‰í¥ í•©ì£¼ ë¼ì´ë¸Œ! | ì•¼ê°„ì‘ì—…ì‹¤ | ë„¤ì´ë²„ NOW.
Clifford Brown - Stompin' at the Savoy | Lennart LÃ¤nk aka helluvagun
Nile Rodgers & CHIC: Tiny Desk Concert | NPR Music
Burning Down the House (2005 Remaster) | Talking Heads
ë¹„ ì˜¤ëŠ” ê±°ë¦¬ì—ì„œ ì¶¤ì„ | Meaningful Stone
ì ì¬(JUKJAE) X ë£¨ì‹œë“œí´ 'ì˜¤, ì‚¬ë‘' Live Clip in Jeju | Jukjae
[I'm LIVE] Meaningful Stone (ê¹€ëœ»ëŒ) & beep-boop-beep-boop (ì‚ë½€ì‚ë½€) | I'm LIVE | ì•„ì„ë¼ì´ë¸Œ
Sonny Rollins  - Plus 4  ( Full Album ) | All That Jazz Don Kaart
Cookin' | Clifford Brown
Stardust | Clifford Brown
Fairytale | Dreamcatcher
little things mean a lot / kitty kallen | okiothfdbyiu
à¸ à¸²à¸à¸à¸±à¸™à¹ƒà¸™à¸ˆà¸±à¸à¸£à¸§à¸²à¸¥ - à¹€à¸‚à¸µà¸¢à¸™à¹„à¸‚à¹à¸¥à¸°à¸§à¸²à¸™à¸´à¸Š live Farmtival â€¢à¸Ÿà¸²à¸£à¹Œà¸¡à¸•à¸´à¸§à¸±à¸¥ vol.1 à¸œà¸¥à¹„à¸¡à¹‰à¸«à¸£à¸£à¸©à¸² | What i like - à¸ªà¸´à¹ˆà¸‡à¸—à¸µà¹ˆà¸à¸¹à¸Šà¸­à¸š
The Sheik of Araby | Coleman Hawkins' All Star Octet
MEENOI (ë¯¸ë…¸ì´) - 'ì–´ë–¨ê²ƒê°™ì•  (Feat. ZICO)' Official Music Video [ENG/CHN] | AOMGOFFICIAL
Art Blakey & the Jazz Messengers - Moanin' | 60otaku4
Work Song | Cannonball Adderley Quintet
OOTD | Dreamcatcher
Love Is Everywhere | Pharoah Sanders
OOTD | Dreamcatcher
Natsuiro Kataomoi | Momoko Kikuchi
She's Funny That Way (1996 Remastered) | Coleman Hawkins & His Orchestra
Dolphin Shoals - Mario Kart 8  *Full Big Band Jazz Fusion version* ft. Bryan Carter | The 8-Bit Big Band
Christmastime Again - Brandon Wilde | JomaMusicGroup
Crazy Train | Ozzy Osbourne
Easy Lover | Earth, Wind & Fire
ìœ í‚¤ì¹´ (YUKIKA) - ê°€ê¹Œì´ í•˜ê³  ì‹¶ì€ ê·¸ëŒ€ Official MV | ìœ í‚¤ì¹´ YUKIKA Official
GHIBLI themes (acapella) | MayTree
Joe Hisaishi - Tonari no Totoro (High Quality) | Vitaly Kogan
Cookin' | Clifford Brown
Beautiful Night | Seori
Dawnlight | g1nger
Loneliness | Ginger Root
SOULSOUP | OFFICIAL HIGE DANDISM
â€˜ëª¨ë“  ì¥ë¥´ ì„­ë µ(?)â€™í•œ ë¯¸ë…¸ì´ê°€ ë¶€ë¥´ëŠ” ìœ¤í•˜ì˜ ï¼œì‚¬ê±´ì˜ ì§€í‰ì„ â™ªï¼ğŸŒŒ [ë” ì‹œì¦Œì¦ˆ-ì•…ë®¤ì˜ ì˜¤ë‚ ì˜¤ë°¤] | KBS 231201 ë°©ì†¡ | KBS Kpop
Who Is Your Guy? (Remix) | Tiwa Savage
Terminator feat. Young Jonn (Official Video) (feat. Young Jonn) | King Promise
[ë¦¬ë¬´ì§„ ì„œë¹„ìŠ¤ í´ë¦½] ì™€ë¥´ë¥´ â™¥ | ë‰´ì§„ìŠ¤ í•˜ë‹ˆ | NewJeans HANNI | KBS Kpop
ë¡œê¼¬ (Loco) : Tiny Desk Korea | Tiny Desk Korea
Somebody! | HWASA
What is Love? | TWICE
Rhapsody in Blue(grass) (feat. Michael Cleveland, Sierra Hull, Justin Moses & Mark Schatz) | BÃ©la Fleck
[4K] ê·œë¹ˆ(Gyubin) â€œReally Like Youâ€ Band LIVE Concert ì—¬ì†” ê³„ë³´ë¥¼ ì´ì„ ê°“ê¸° ë“±ì¥ğŸ™ [itâ€™s KPOP LIVE ì‡ì¸ ë¼ì´ë¸Œ] | it's Live
See tÃ¬nh | HoÃ ng ThÃ¹y Linh
bloom | Necry Talkie
Amor Eterno (En Vivo [Desde el Instituto Nacional de Bellas A... | Juan Gabriel
Mario Kart Coconut Mall (acapella) | MayTree
TWICE "I GOT YOU" Live Clip | TWICE
[ì•¼ê°„í•©ì£¼ì‹¤] ë©œë¡œë§ìŠ¤ & ì•”í˜¸ì¤€ì¬ - 'Gravity' ì¦‰í¥í•©ì£¼ ë¼ì´ë¸Œ! | ì•¼ê°„ì‘ì—…ì‹¤ | ë„¤ì´ë²„ NOW.
Hold The Line (Official Video) | Toto
Modern Love | David Bowie
ã‚«ãƒ³ãƒˆãƒªãƒ¼ãƒ»ãƒ­ãƒ¼ãƒ‰ï¼ˆCoverï¼‰ | Goose house
I'm in Love | Tomoko Aran
Any angle | noa
Chet Baker - I fall in love too easily | nadziejaszek
Dream A Little Dream Of Me | Ella Fitzgerald
[ë¦¬ë¬´ì§„ ì„œë¹„ìŠ¤ í´ë¦½] Polaroid love | ë¥´ì„¸ë¼í•Œ ê¹€ì±„ì› X ì´ë¬´ì§„ |  LE SSERAFIM CHAEWON X LEE MU JIN | KBS Kpop
All Night (feat. Saweetie) | IVE
Starlight | Dreamcatcher
FrÃ¡gil (Official Video) | Yahritza Y Su Esencia
Roy Hargrove   I remember Clifford | mjlex05
A Beautiful Farewell | CHUU
Sugarcane (Remix) (feat. King Promise) | Camidoh
RUSH | TWICE
Kim Jong Kook - Loveable (Sarang Surowo) [MV] | Kim Jong Kook
Queen of Hearts (Live) | TWICE
MANIAC | VIVIZ
íŠ¸ì™€ì´ìŠ¤(TWICE)ì˜ í‚¬ë§ë³´ì´ìŠ¤ë¥¼ ë¼ì´ë¸Œë¡œ!ã…£OOH-AHHí•˜ê²Œ, CHEER UP, TT, KNOCK KNOCK, Heart shaker, YES or YES, ONE SPARK | ë”©ê³  ë®¤ì§ / dingo music
TWICE "ONE SPARK" Live Stage @ TWICE 5TH WORLD TOUR 'READY TO BE' ONCE MORE IN LAS VEGAS | TWICE
Easy | Stray Kids
Bruno Mars & Anderson .Paak: â€˜An Evening With Silk Sonicâ€™ Interview | Apple Music | Apple Music
COBALT | Meaningful Stone
ZezÃ© | IU
Suggestions | Everybody Wants to Rule the World (feat. Cory Henry)
Magnetic | ILLIT
Lose Control | JJ Lin
Nanidato (ãƒŠãƒ‹ãƒ€ãƒˆ) - SUPER RISER! (Remake) | M A R Iãƒãƒªãã‚“
Bbq Song (Live with the Homestead Pickers) | Rhett and Link
Am I Dreaming | Metro Boomin
Smart | LE SSERAFIM
Refresh | Related playlists
Related playlists | Presenting Breakbot
Presenting Breakbot | Playlist
Playlist |  â€¢ 
 â€¢  | YouTube Music
YouTube Music | Presenting Frank Sinatra
Presenting Frank Sinatra | Playlist
Playlist |  â€¢ 
 â€¢  | YouTube Music
YouTube Music | music playlist
music playlist | Playlist
Playlist |  â€¢ 
 â€¢  | Nums
Nums |  â€¢ 
 â€¢  | 556 views
556 views | Presenting Snail's House
Presenting Snail's House | Playlist
Playlist |  â€¢ 
 â€¢  | YouTube Music
YouTube Music | Presenting Gorillaz
Presenting Gorillaz | Playlist
Playlist |  â€¢ 
 â€¢  | YouTube Music
YouTube Music | Presenting Twenty One Pilots 
Presenting Twenty One Pilots  | Playlist
Playlist |  â€¢ 
 â€¢  | YouTube Music
YouTube Music | Presenting Foster the People
Presenting Foster the People | Playlist
Playlist |  â€¢ 
 â€¢  | YouTube Music
YouTube Music | Presenting Gus Dapperton
Presenting Gus Dapperton | Playlist
Playlist |  â€¢ 
 â€¢  | YouTube Music
YouTube Music | Bedroom Pop
Bedroom Pop | Playlist
Playlist |  â€¢ 
 â€¢  | YouTube Music
YouTube Music | Line
Line | Playlist
Playlist |  â€¢ 
 â€¢  | Troy
Troy |  â€¢ 
 â€¢  | 480 views
